County,year,,money_bond_freq,pr_bond_freq,total_bond_freq,off_type,money_posted,money_bond_new_no,money_new_yes,pr_posted,pr_new_no,pr_new_yes,total_new,Crimes,Offenses,EstPopulation
"Adams",2014,1,8022,156,8178,"Misdemeanor",5369,4650,719,286,250,36,5655,54159,52998,828003
"Adams",2014,190,3166,215,3381,"Felony",1846,1467,379,221,195,26,2067,54159,52998,828003
"Adams",2015,2,8018,308,8326,"Misdemeanor",5243,4512,731,369,335,34,5612,56921,55688,849660
"Adams",2015,191,3305,354,3659,"Felony",1916,1517,399,345,286,59,2261,56921,55688,849660
"Adams",2016,3,6789,1211,8000,"Misdemeanor",3672,3149,523,1307,1113,194,4979,63067,61508,849660
"Adams",2016,192,3307,713,4020,"Felony",1835,1444,391,720,619,101,2555,63067,61508,849660
"Alamosa",2014,4,317,112,429,"Misdemeanor",188,154,34,110,88,22,298,161,161,16436
"Alamosa",2014,193,212,84,296,"Felony",108,84,24,82,67,15,190,161,161,16436
"Alamosa",2015,5,367,122,489,"Misdemeanor",219,154,65,115,84,31,334,380,369,16307
"Alamosa",2015,194,260,86,346,"Felony",138,99,39,85,68,17,223,380,369,16307
"Alamosa",2016,6,328,184,512,"Misdemeanor",166,135,31,178,141,37,344,272,272,16307
"Alamosa",2016,195,341,215,556,"Felony",165,122,43,214,167,47,379,272,272,16307
"Arapahoe",2014,7,4405,3151,7556,"Misdemeanor",2589,2184,405,2091,1820,271,4680,15502,15197,315711
"Arapahoe",2014,196,2631,364,2995,"Felony",1501,1206,295,356,302,54,1857,15502,15197,315711
"Arapahoe",2015,8,3703,3890,7593,"Misdemeanor",2329,1976,353,2317,2049,268,4646,16124,15835,322928
"Arapahoe",2015,197,2482,668,3150,"Felony",1504,1226,278,668,565,103,2172,16124,15835,322928
"Arapahoe",2016,9,4693,2393,7086,"Misdemeanor",2099,1876,223,1583,1421,162,3682,16779,16491,320358
"Arapahoe",2016,198,2709,503,3212,"Felony",1692,1432,260,507,443,64,2199,16779,16491,320358
"Archuleta",2014,10,212,118,330,"Misdemeanor",135,118,17,119,100,19,254,419,416,12297
"Archuleta",2014,199,46,41,87,"Felony",30,22,8,42,33,9,72,419,416,12297
"Archuleta",2015,11,156,97,253,"Misdemeanor",114,95,19,93,71,22,207,423,413,12334
"Archuleta",2015,200,46,36,82,"Felony",31,22,9,36,28,8,67,423,413,12334
"Archuleta",2016,12,194,126,320,"Misdemeanor",128,99,29,127,97,30,255,371,370,12334
"Archuleta",2016,201,49,46,95,"Felony",32,21,11,47,27,20,79,371,370,12334
"Baca",2014,13,103,10,113,"Misdemeanor",55,51,4,10,10,NA,65,56,52,3677
"Baca",2014,202,27,3,30,"Felony",17,13,4,3,3,NA,20,56,52,3677
"Baca",2015,14,106,7,113,"Misdemeanor",51,43,8,7,6,1,58,62,56,3624
"Baca",2015,203,18,11,29,"Felony",13,8,5,10,10,NA,23,62,56,3624
"Baca",2016,15,105,7,112,"Misdemeanor",54,46,8,8,8,NA,62,72,71,3624
"Baca",2016,204,26,6,32,"Felony",10,9,1,6,4,2,16,72,71,3624
"Bent",2014,16,184,53,237,"Misdemeanor",151,114,37,49,36,13,200,147,139,7748
"Bent",2014,205,35,14,49,"Felony",28,17,11,15,10,5,43,147,139,7748
"Bent",2015,17,109,52,161,"Misdemeanor",74,60,14,46,40,6,120,113,109,7599
"Bent",2015,206,30,18,48,"Felony",24,16,8,16,13,3,40,113,109,7599
"Bent",2016,18,116,65,181,"Misdemeanor",70,53,17,59,42,17,129,227,225,7599
"Bent",2016,207,53,13,66,"Felony",35,25,10,12,6,6,47,227,225,7599
"Boulder",2014,19,2444,545,2989,"Misdemeanor",1444,1256,188,590,543,47,2034,12860,12560,306291
"Boulder",2014,208,1548,215,1763,"Felony",842,715,127,235,217,18,1077,12860,12560,306291
"Boulder",2015,20,2346,637,2983,"Misdemeanor",1331,1149,182,645,593,52,1976,14892,14442,309565
"Boulder",2015,209,1630,294,1924,"Felony",904,756,148,308,282,26,1212,14892,14442,309565
"Boulder",2016,21,2275,860,3135,"Misdemeanor",1265,1086,179,848,758,90,2113,17017,16580,309565
"Boulder",2016,210,1662,536,2198,"Felony",898,763,135,550,496,54,1448,17017,16580,309565
"Broomfield",2014,22,1213,86,1299,"Misdemeanor",905,833,72,86,77,9,991,2144,2110,63935
"Broomfield",2014,211,285,11,296,"Felony",199,167,32,11,10,1,210,2144,2110,63935
"Broomfield",2015,23,1082,76,1158,"Misdemeanor",771,679,92,74,69,5,845,2370,2344,68158
"Broomfield",2015,212,275,17,292,"Felony",173,141,32,18,17,1,191,2370,2344,68158
"Broomfield",2016,24,826,262,1088,"Misdemeanor",518,453,65,264,233,31,782,3189,3152,63935
"Broomfield",2016,213,265,68,333,"Felony",170,140,30,69,61,8,239,3189,3152,63935
"Chaffee",2014,25,299,103,402,"Misdemeanor",196,171,25,103,95,8,299,580,570,18797
"Chaffee",2014,214,103,23,126,"Felony",67,58,9,25,24,1,92,580,570,18797
"Chaffee",2015,26,290,153,443,"Misdemeanor",175,152,23,158,136,22,333,560,548,18574
"Chaffee",2015,215,122,36,158,"Felony",60,50,10,36,29,7,96,560,548,18574
"Chaffee",2016,27,271,184,455,"Misdemeanor",149,119,30,175,146,29,324,669,656,18574
"Chaffee",2016,216,129,54,183,"Felony",56,42,14,57,44,13,113,669,656,18574
"Cheyenne",2014,28,41,6,47,"Misdemeanor",21,19,2,6,5,1,27,6,6,1915
"Cheyenne",2014,217,10,3,13,"Felony",5,4,1,2,2,NA,7,6,6,1915
"Cheyenne",2015,29,44,1,45,"Misdemeanor",24,23,1,1,1,NA,25,9,7,1887
"Cheyenne",2015,218,7,1,8,"Felony",7,7,NA,1,1,NA,8,9,7,1887
"Cheyenne",2016,30,71,8,79,"Misdemeanor",31,27,4,8,6,2,39,11,11,1887
"Cheyenne",2016,219,11,2,13,"Felony",10,7,3,1,1,NA,11,11,11,1887
"Clear Creek",2014,31,360,133,493,"Misdemeanor",215,190,25,24,19,5,239,456,425,9064
"Clear Creek",2014,220,79,4,83,"Felony",55,48,7,3,3,NA,58,456,425,9064
"Clear Creek",2015,32,382,141,523,"Misdemeanor",246,224,22,30,29,1,276,490,459,9525
"Clear Creek",2015,221,63,4,67,"Felony",41,33,8,4,2,2,45,490,459,9525
"Clear Creek",2016,33,393,122,515,"Misdemeanor",224,194,30,38,29,9,262,500,479,9525
"Clear Creek",2016,222,80,6,86,"Felony",51,45,6,5,4,1,56,500,479,9525
"Conejos",2014,34,132,35,167,"Misdemeanor",85,72,13,33,24,9,118,45,44,9192
"Conejos",2014,223,36,14,50,"Felony",16,12,4,13,11,2,29,45,44,9192
"Conejos",2015,35,112,47,159,"Misdemeanor",71,59,12,47,42,5,118,78,78,9159
"Conejos",2015,224,51,17,68,"Felony",38,28,10,19,13,6,57,78,78,9159
"Conejos",2016,36,115,42,157,"Misdemeanor",77,61,16,40,30,10,117,103,102,8292
"Conejos",2016,225,75,27,102,"Felony",50,32,18,26,22,4,76,103,102,8292
"Costilla",2014,37,121,28,149,"Misdemeanor",70,61,9,22,19,3,92,91,87,3536
"Costilla",2014,226,34,10,44,"Felony",26,20,6,6,5,1,32,91,87,3536
"Costilla",2015,38,120,21,141,"Misdemeanor",86,73,13,20,18,2,106,21,20,3592
"Costilla",2015,227,41,5,46,"Felony",34,29,5,7,7,NA,41,21,20,3592
"Costilla",2016,39,115,24,139,"Misdemeanor",55,49,6,18,17,1,73,0,0,3592
"Costilla",2016,228,33,17,50,"Felony",23,22,1,14,14,NA,37,0,0,3592
"Crowley",2014,40,54,20,74,"Misdemeanor",40,32,8,21,18,3,61,33,32,5231
"Crowley",2014,229,26,2,28,"Felony",17,13,4,4,2,2,21,33,32,5231
"Crowley",2015,41,51,28,79,"Misdemeanor",37,29,8,29,22,7,66,152,148,5267
"Crowley",2015,230,25,20,45,"Felony",20,16,4,21,18,3,41,152,148,5267
"Crowley",2016,42,34,15,49,"Misdemeanor",22,19,3,14,8,6,36,146,146,5267
"Crowley",2016,231,55,9,64,"Felony",40,33,7,10,5,5,50,146,146,5267
"Custer",2014,43,48,14,62,"Misdemeanor",38,32,6,14,14,NA,52,86,81,4311
"Custer",2014,232,17,4,21,"Felony",14,12,2,3,2,1,17,86,81,4311
"Custer",2015,44,71,24,95,"Misdemeanor",46,40,6,24,21,3,70,213,203,4399
"Custer",2015,233,19,5,24,"Felony",8,8,NA,8,8,NA,16,213,203,4399
"Custer",2016,45,47,29,76,"Misdemeanor",36,29,7,30,26,4,66,294,276,4399
"Custer",2016,234,39,11,50,"Felony",24,23,1,12,11,1,36,294,276,4399
"Delta",2014,46,428,66,494,"Misdemeanor",283,234,49,130,115,15,413,995,961,30561
"Delta",2014,235,117,11,128,"Felony",65,46,19,32,23,9,97,995,961,30561
"Delta",2015,47,460,70,530,"Misdemeanor",297,256,41,146,124,22,443,1074,1051,29735
"Delta",2015,236,112,13,125,"Felony",61,40,21,35,29,6,96,1074,1051,29735
"Delta",2016,48,557,65,622,"Misdemeanor",282,252,30,217,179,38,499,1014,982,29735
"Delta",2016,237,114,15,129,"Felony",59,41,18,42,36,6,101,1014,982,29735
"Dolores",2014,49,29,10,39,"Misdemeanor",18,15,3,8,8,NA,26,33,33,2032
"Dolores",2014,241,3,5,8,"Felony",3,2,1,5,4,1,8,33,33,2032
"Dolores",2015,50,26,15,41,"Misdemeanor",12,11,1,8,8,NA,20,41,40,1965
"Dolores",2015,242,9,2,11,"Felony",5,4,1,2,2,NA,7,41,40,1965
"Dolores",2016,51,15,24,39,"Misdemeanor",8,7,1,12,11,1,20,65,64,1965
"Dolores",2016,243,16,1,17,"Felony",12,11,1,1,1,NA,13,65,64,1965
"Douglas",2014,52,2230,625,2855,"Misdemeanor",1339,1199,140,582,529,53,1921,8051,7848,312386
"Douglas",2014,244,582,112,694,"Felony",343,295,48,110,98,12,453,8051,7848,312386
"Douglas",2015,53,2315,975,3290,"Misdemeanor",1381,1260,121,928,840,88,2309,10421,10210,322839
"Douglas",2015,245,573,197,770,"Felony",357,302,55,198,175,23,555,10421,10210,322839
"Douglas",2016,54,2810,979,3789,"Misdemeanor",1581,1444,137,943,842,101,2524,11822,11563,322839
"Douglas",2016,246,750,279,1029,"Felony",476,419,57,276,244,32,752,11822,11563,322839
"Eagle",2014,55,759,228,987,"Misdemeanor",362,317,45,223,197,26,585,2281,2235,54826
"Eagle",2014,247,225,34,259,"Felony",180,164,16,34,32,2,214,2281,2235,54826
"Eagle",2015,56,861,166,1027,"Misdemeanor",419,359,60,208,188,20,627,2342,2282,55332
"Eagle",2015,248,332,24,356,"Felony",257,238,19,26,26,NA,283,2342,2282,55332
"Eagle",2016,57,891,158,1049,"Misdemeanor",483,417,66,166,147,19,649,2079,2042,55332
"Eagle",2016,249,283,17,300,"Felony",201,189,12,18,17,1,219,2079,2042,55332
"El Paso",2014,58,7742,993,8735,"Misdemeanor",3521,3085,436,1176,1099,77,4697,43401,42706,666136
"El Paso",2014,250,5041,318,5359,"Felony",2834,2222,612,366,326,40,3200,43401,42706,666136
"El Paso",2015,59,8076,1069,9145,"Misdemeanor",3720,3262,458,1097,1030,67,4817,43221,42448,675511
"El Paso",2015,251,5260,362,5622,"Felony",2800,2277,523,359,326,33,3159,43221,42448,675511
"El Paso",2016,60,8061,1074,9135,"Misdemeanor",3212,2841,371,1087,1020,67,4299,43647,42856,675511
"El Paso",2016,252,5781,325,6106,"Felony",3043,2546,497,330,301,29,3373,43647,42856,675511
"Elbert",2014,61,226,77,303,"Misdemeanor",152,137,15,75,66,9,227,80,80,24047
"Elbert",2014,253,53,11,64,"Felony",35,27,8,10,10,NA,45,80,80,24047
"Elbert",2015,62,240,82,322,"Misdemeanor",162,137,25,81,69,12,243,72,63,24565
"Elbert",2015,254,63,19,82,"Felony",46,36,10,19,15,4,65,72,63,24565
"Elbert",2016,63,212,117,329,"Misdemeanor",154,138,16,116,95,21,270,42,40,24565
"Elbert",2016,255,86,35,121,"Felony",64,52,12,35,31,4,99,42,40,24565
"Fremont",2014,64,563,193,756,"Misdemeanor",399,337,62,94,79,15,493,2014,1927,46611
"Fremont",2014,256,259,64,323,"Felony",170,141,29,41,36,5,211,2014,1927,46611
"Fremont",2015,65,636,226,862,"Misdemeanor",445,390,55,219,172,47,664,1994,1898,46580
"Fremont",2015,257,282,93,375,"Felony",149,124,25,88,79,9,237,1994,1898,46580
"Fremont",2016,66,423,594,1017,"Misdemeanor",198,162,36,586,513,73,784,897,871,46580
"Fremont",2016,258,379,230,609,"Felony",144,111,33,220,183,37,364,897,871,46580
"Garfield",2014,67,1057,271,1328,"Misdemeanor",620,492,128,310,244,66,930,2392,2332,57939
"Garfield",2014,259,283,88,371,"Felony",194,137,57,106,77,29,300,2392,2332,57939
"Garfield",2015,68,1104,288,1392,"Misdemeanor",671,550,121,308,272,36,979,2858,2818,58026
"Garfield",2015,260,401,84,485,"Felony",252,172,80,108,77,31,360,2858,2818,58026
"Garfield",2016,69,1113,326,1439,"Misdemeanor",590,504,86,355,297,58,945,2789,2722,58026
"Garfield",2016,261,386,138,524,"Felony",258,186,72,150,127,23,408,2789,2722,58026
"Gilpin",2014,70,422,72,494,"Misdemeanor",286,254,32,73,62,11,359,1539,1523,5667
"Gilpin",2014,262,78,16,94,"Felony",64,56,8,16,15,1,80,1539,1523,5667
"Gilpin",2015,71,509,122,631,"Misdemeanor",356,309,47,122,113,9,478,1357,1350,5975
"Gilpin",2015,263,149,25,174,"Felony",112,96,16,25,23,2,137,1357,1350,5975
"Gilpin",2016,72,384,126,510,"Misdemeanor",231,209,22,122,109,13,353,1144,1139,5975
"Gilpin",2016,264,124,27,151,"Felony",77,72,5,28,25,3,105,1144,1139,5975
"Grand",2014,73,303,21,324,"Misdemeanor",223,202,21,19,18,1,242,304,300,14249
"Grand",2014,265,63,7,70,"Felony",44,36,8,7,5,2,51,304,300,14249
"Grand",2015,74,240,65,305,"Misdemeanor",182,162,20,62,56,6,244,329,326,14542
"Grand",2015,266,41,8,49,"Felony",29,25,4,8,8,NA,37,329,326,14542
"Grand",2016,75,258,95,353,"Misdemeanor",181,159,22,93,77,16,274,244,240,14542
"Grand",2016,267,48,14,62,"Felony",33,27,6,14,12,2,47,244,240,14542
"Gunnison",2014,76,326,40,366,"Misdemeanor",256,226,30,41,38,3,297,594,554,15628
"Gunnison",2014,268,85,7,92,"Felony",73,60,13,7,7,NA,80,594,554,15628
"Gunnison",2015,77,363,48,411,"Misdemeanor",294,256,38,53,44,9,347,600,573,15873
"Gunnison",2015,269,72,15,87,"Felony",53,46,7,14,11,3,67,600,573,15873
"Gunnison",2016,78,363,43,406,"Misdemeanor",283,243,40,42,36,6,325,629,598,15873
"Gunnison",2016,270,102,13,115,"Felony",76,55,21,11,9,2,87,629,598,15873
"Hinsdale",2014,79,10,NA,10,"Misdemeanor",4,4,NA,NA,NA,NA,4,8,8,810
"Hinsdale",2014,271,2,1,3,"Felony",1,1,NA,1,1,NA,2,8,8,810
"Hinsdale",2015,80,6,5,11,"Misdemeanor",5,5,NA,NA,NA,NA,5,10,10,775
"Hinsdale",2015,272,3,NA,3,"Felony",2,2,NA,1,1,NA,3,10,10,775
"Hinsdale",2016,81,6,3,9,"Misdemeanor",1,1,NA,NA,NA,NA,1,15,13,775
"Hinsdale",2016,273,2,2,4,"Felony",2,2,NA,1,NA,1,3,15,13,775
"Huerfano",2014,82,228,25,253,"Misdemeanor",107,94,13,25,24,1,132,359,336,6520
"Huerfano",2014,274,78,36,114,"Felony",47,34,13,37,31,6,84,359,336,6520
"Huerfano",2015,83,234,26,260,"Misdemeanor",100,81,19,26,22,4,126,435,407,6435
"Huerfano",2015,275,69,20,89,"Felony",45,34,11,20,15,5,65,435,407,6435
"Huerfano",2016,84,224,36,260,"Misdemeanor",88,79,9,36,29,7,124,544,518,6435
"Huerfano",2016,276,96,41,137,"Felony",59,49,10,42,28,14,101,544,518,6435
"Jackson",2014,85,17,12,29,"Misdemeanor",11,9,2,12,9,3,23,3,3,1369
"Jackson",2014,277,4,2,6,"Felony",3,3,NA,1,1,NA,4,3,3,1369
"Jackson",2015,86,14,7,21,"Misdemeanor",8,7,1,7,6,1,15,1,1,1404
"Jackson",2015,278,1,4,5,"Felony",1,1,NA,3,3,NA,4,1,1,1404
"Jackson",2016,87,15,3,18,"Misdemeanor",3,3,NA,3,2,1,6,11,11,1404
"Jackson",2016,279,8,2,10,"Felony",7,5,2,2,2,NA,9,11,11,1404
"Jefferson",2014,88,4831,813,5644,"Misdemeanor",2360,2079,281,806,739,67,3166,27809,27426,515493
"Jefferson",2014,280,2619,437,3056,"Felony",1416,1179,237,448,399,49,1864,27809,27426,515493
"Jefferson",2015,89,4920,964,5884,"Misdemeanor",2321,2022,299,952,862,90,3273,31197,30747,522599
"Jefferson",2015,281,3032,440,3472,"Felony",1611,1343,268,456,410,46,2067,31197,30747,522599
"Jefferson",2016,90,5304,1097,6401,"Misdemeanor",2285,2022,263,1046,957,89,3331,33978,33397,522599
"Jefferson",2016,282,3404,539,3943,"Felony",1738,1503,235,563,493,70,2301,33978,33397,522599
"Kiowa",2014,91,87,3,90,"Misdemeanor",44,41,3,2,2,NA,46,0,0,1439
"Kiowa",2014,283,8,2,10,"Felony",6,4,2,2,1,1,8,0,0,1439
"Kiowa",2015,92,65,4,69,"Misdemeanor",26,25,1,4,4,NA,30,0,0,1409
"Kiowa",2015,284,9,1,10,"Felony",4,4,NA,1,NA,1,5,0,0,1409
"Kiowa",2016,93,53,3,56,"Misdemeanor",26,24,2,3,3,NA,29,0,0,1409
"Kiowa",2016,285,4,NA,4,"Felony",2,2,NA,NA,NA,NA,2,0,0,1409
"Kit Carson",2014,94,181,39,220,"Misdemeanor",112,101,11,37,29,8,149,321,314,8032
"Kit Carson",2014,286,49,6,55,"Felony",29,24,5,5,3,2,34,321,314,8032
"Kit Carson",2015,95,164,62,226,"Misdemeanor",105,94,11,58,51,7,163,328,315,8061
"Kit Carson",2015,287,54,14,68,"Felony",33,23,10,13,13,NA,46,328,315,8061
"Kit Carson",2016,96,196,73,269,"Misdemeanor",108,88,20,70,61,9,178,346,331,8061
"Kit Carson",2016,288,61,27,88,"Felony",35,23,12,26,15,11,61,346,331,8061
"La Plata",2014,97,753,463,1216,"Misdemeanor",450,389,61,380,303,77,830,1731,1699,54054
"La Plata",2014,289,249,224,473,"Felony",141,89,52,184,135,49,325,1731,1699,54054
"La Plata",2015,98,906,541,1447,"Misdemeanor",547,476,71,507,408,99,1054,2238,2197,54874
"La Plata",2015,290,281,210,491,"Felony",174,139,35,199,150,49,373,2238,2197,54874
"La Plata",2016,99,1000,463,1463,"Misdemeanor",617,549,68,430,366,64,1047,2374,2316,54874
"La Plata",2016,291,324,178,502,"Felony",216,183,33,163,139,24,379,2374,2316,54874
"Lake",2014,100,152,63,215,"Misdemeanor",107,91,16,64,51,13,171,256,244,7359
"Lake",2014,292,77,8,85,"Felony",59,47,12,8,7,1,67,256,244,7359
"Lake",2015,101,242,68,310,"Misdemeanor",182,148,34,67,56,11,249,173,160,7408
"Lake",2015,293,40,6,46,"Felony",31,27,4,6,6,NA,37,173,160,7408
"Lake",2016,102,212,50,262,"Misdemeanor",150,122,28,47,43,4,197,279,263,7408
"Lake",2016,294,68,14,82,"Felony",56,47,9,13,11,2,69,279,263,7408
"Larimer",2014,103,2059,3712,5771,"Misdemeanor",1350,1091,259,2986,2705,281,4336,15409,14929,321547
"Larimer",2014,295,1309,472,1781,"Felony",765,609,156,439,388,51,1204,15409,14929,321547
"Larimer",2015,104,2278,3780,6058,"Misdemeanor",1459,1181,278,2908,2581,327,4367,16829,16397,331509
"Larimer",2015,296,1647,508,2155,"Felony",941,735,206,465,410,55,1406,16829,16397,331509
"Larimer",2016,105,2306,3737,6043,"Misdemeanor",1395,1133,262,2827,2542,285,4222,18257,17788,331509
"Larimer",2016,297,2130,645,2775,"Felony",1161,905,256,586,522,64,1747,18257,17788,331509
"Las Animas",2014,106,706,123,829,"Misdemeanor",465,385,80,132,86,46,597,602,590,14296
"Las Animas",2014,298,105,62,167,"Felony",72,55,17,62,48,14,134,602,590,14296
"Las Animas",2015,107,698,86,784,"Misdemeanor",399,337,62,94,70,24,493,718,701,13782
"Las Animas",2015,299,137,62,199,"Felony",77,60,17,65,46,19,142,718,701,13782
"Las Animas",2016,108,781,65,846,"Misdemeanor",400,335,65,65,47,18,465,758,747,13782
"Las Animas",2016,300,112,43,155,"Felony",70,52,18,44,30,14,114,758,747,13782
"Lincoln",2014,109,238,8,246,"Misdemeanor",100,89,11,6,6,NA,106,69,67,5451
"Lincoln",2014,301,63,3,66,"Felony",22,19,3,4,4,NA,26,69,67,5451
"Lincoln",2015,110,354,5,359,"Misdemeanor",99,86,13,8,6,2,107,77,77,5540
"Lincoln",2015,302,80,NA,80,"Felony",25,24,1,NA,NA,NA,25,77,77,5540
"Lincoln",2016,111,389,8,397,"Misdemeanor",106,97,9,11,10,1,117,98,97,5540
"Lincoln",2016,303,84,3,87,"Felony",44,34,10,2,1,1,46,98,97,5540
"Logan",2014,112,326,160,486,"Misdemeanor",204,169,35,155,124,31,359,1223,1195,22492
"Logan",2014,304,153,73,226,"Felony",85,64,21,68,54,14,153,1223,1195,22492
"Logan",2015,113,243,211,454,"Misdemeanor",168,134,34,203,163,40,371,1580,1543,22542
"Logan",2015,305,169,65,234,"Felony",104,79,25,67,54,13,171,1580,1543,22542
"Logan",2016,114,249,186,435,"Misdemeanor",166,135,31,172,141,31,338,1432,1407,22542
"Logan",2016,306,194,82,276,"Felony",95,77,18,72,64,8,167,1432,1407,22542
"Mesa",2014,115,1508,1312,2820,"Misdemeanor",604,466,138,1309,1088,221,1913,9450,9274,148670
"Mesa",2014,307,785,721,1506,"Felony",363,277,86,721,585,136,1084,9450,9274,148670
"Mesa",2015,116,1686,1317,3003,"Misdemeanor",591,483,108,1314,1053,261,1905,10363,10140,149249
"Mesa",2015,308,755,817,1572,"Felony",288,230,58,824,671,153,1112,10363,10140,149249
"Mesa",2016,117,1589,1402,2991,"Misdemeanor",451,376,75,1399,1119,280,1850,10562,10370,149249
"Mesa",2016,309,957,1034,1991,"Felony",314,252,62,1043,849,194,1357,10562,10370,149249
"Mineral",2014,118,40,NA,40,"Misdemeanor",14,13,1,NA,NA,NA,14,5,5,729
"Mineral",2014,310,2,NA,2,"Felony",2,2,NA,NA,NA,NA,2,5,5,729
"Mineral",2015,119,43,2,45,"Misdemeanor",14,14,NA,1,1,NA,15,3,3,700
"Mineral",2015,311,1,3,4,"Felony",NA,NA,NA,2,1,1,2,3,3,700
"Mineral",2016,120,36,2,38,"Misdemeanor",7,7,NA,2,2,NA,9,0,0,700
"Mineral",2016,312,1,NA,1,"Felony",1,1,NA,NA,NA,NA,1,0,0,700
"Moffat",2014,121,246,95,341,"Misdemeanor",177,137,40,92,69,23,269,603,591,13009
"Moffat",2014,313,134,27,161,"Felony",92,62,30,28,23,5,120,603,591,13009
"Moffat",2015,122,257,115,372,"Misdemeanor",176,142,34,116,89,27,292,820,802,12766
"Moffat",2015,314,164,67,231,"Felony",121,82,39,65,53,12,186,820,802,12766
"Moffat",2016,123,246,157,403,"Misdemeanor",150,123,27,147,121,26,297,938,907,12766
"Moffat",2016,315,160,93,253,"Felony",97,68,29,89,75,14,186,938,907,12766
"Montezuma",2014,124,402,466,868,"Misdemeanor",276,250,26,368,308,60,644,999,960,25815
"Montezuma",2014,316,136,67,203,"Felony",86,73,13,67,54,13,153,999,960,25815
"Montezuma",2015,125,413,403,816,"Misdemeanor",269,226,43,298,255,43,567,927,904,25926
"Montezuma",2015,317,184,60,244,"Felony",140,121,19,57,49,8,197,927,904,25926
"Montezuma",2016,126,421,434,855,"Misdemeanor",252,229,23,275,250,25,527,897,883,25926
"Montezuma",2016,318,217,61,278,"Felony",154,137,17,61,55,6,215,897,883,25926
"Montrose",2014,127,700,155,855,"Misdemeanor",522,393,129,180,153,27,702,2168,2091,40826
"Montrose",2014,319,282,21,303,"Felony",166,110,56,45,35,10,211,2168,2091,40826
"Montrose",2015,128,648,130,778,"Misdemeanor",421,328,93,173,137,36,594,2184,2099,40948
"Montrose",2015,320,276,21,297,"Felony",174,113,61,49,37,12,223,2184,2099,40948
"Montrose",2016,129,607,181,788,"Misdemeanor",393,309,84,238,189,49,631,2279,2213,40948
"Montrose",2016,321,267,34,301,"Felony",191,112,79,71,59,12,262,2279,2213,40948
"Morgan",2014,130,755,201,956,"Misdemeanor",336,288,48,176,151,25,512,1135,1107,28630
"Morgan",2014,322,182,53,235,"Felony",113,74,39,52,44,8,165,1135,1107,28630
"Morgan",2015,131,775,238,1013,"Misdemeanor",352,303,49,230,187,43,582,1167,1139,28480
"Morgan",2015,323,169,81,250,"Felony",98,77,21,78,59,19,176,1167,1139,28480
"Morgan",2016,132,693,247,940,"Misdemeanor",319,279,40,231,194,37,550,1150,1120,28480
"Morgan",2016,324,207,90,297,"Felony",108,81,27,89,64,25,197,1150,1120,28480
"Otero",2014,133,479,157,636,"Misdemeanor",369,290,79,161,132,29,530,794,783,18759
"Otero",2014,325,139,65,204,"Felony",99,76,23,64,45,19,163,794,783,18759
"Otero",2015,134,376,228,604,"Misdemeanor",312,253,59,191,159,32,503,910,906,18454
"Otero",2015,326,171,53,224,"Felony",136,88,48,51,35,16,187,910,906,18454
"Otero",2016,135,210,305,515,"Misdemeanor",180,135,45,241,208,33,421,914,890,18454
"Otero",2016,327,153,65,218,"Felony",109,79,30,64,48,16,173,914,890,18454
"Ouray",2014,136,88,19,107,"Misdemeanor",68,60,8,13,10,3,81,37,37,4608
"Ouray",2014,328,14,2,16,"Felony",8,6,2,2,2,NA,10,37,37,4608
"Ouray",2015,137,79,14,93,"Misdemeanor",46,41,5,13,12,1,59,74,64,4689
"Ouray",2015,329,15,2,17,"Felony",12,9,3,3,2,1,15,74,64,4689
"Ouray",2016,138,99,13,112,"Misdemeanor",60,51,9,13,11,2,73,40,40,4689
"Ouray",2016,330,22,2,24,"Felony",19,15,4,3,2,1,22,40,40,4689
"Park",2014,139,313,66,379,"Misdemeanor",232,211,21,73,67,6,305,201,194,16176
"Park",2014,331,53,13,66,"Felony",38,31,7,17,15,2,55,201,194,16176
"Park",2015,140,292,84,376,"Misdemeanor",172,158,14,96,88,8,268,210,207,16426
"Park",2015,332,61,17,78,"Felony",52,42,10,19,14,5,71,210,207,16426
"Park",2016,141,251,105,356,"Misdemeanor",154,139,15,103,92,11,257,229,228,16426
"Park",2016,333,56,11,67,"Felony",43,40,3,11,9,2,54,229,228,16426
"Phillips",2014,142,39,5,44,"Misdemeanor",27,21,6,5,4,1,32,91,86,4356
"Phillips",2014,334,12,NA,12,"Felony",9,7,2,NA,NA,NA,9,91,86,4356
"Phillips",2015,143,41,22,63,"Misdemeanor",27,19,8,21,14,7,48,150,141,4355
"Phillips",2015,335,18,2,20,"Felony",15,11,4,2,2,NA,17,150,141,4355
"Phillips",2016,144,54,21,75,"Misdemeanor",36,30,6,16,15,1,52,111,106,4355
"Phillips",2016,336,15,7,22,"Felony",12,11,1,7,7,NA,19,111,106,4355
"Pitkin",2014,145,164,61,225,"Misdemeanor",117,97,20,62,50,12,179,648,641,16591
"Pitkin",2014,337,38,4,42,"Felony",30,25,5,4,3,1,34,648,641,16591
"Pitkin",2015,146,121,53,174,"Misdemeanor",74,65,9,53,43,10,127,784,767,16844
"Pitkin",2015,338,62,13,75,"Felony",51,44,7,13,9,4,64,784,767,16844
"Pitkin",2016,147,169,41,210,"Misdemeanor",94,80,14,39,32,7,133,772,760,16844
"Pitkin",2016,339,53,22,75,"Felony",42,32,10,23,20,3,65,772,760,16844
"Prowers",2014,148,629,68,697,"Misdemeanor",334,270,64,73,47,26,407,486,484,12293
"Prowers",2014,340,108,47,155,"Felony",76,63,13,47,36,11,123,486,484,12293
"Prowers",2015,149,662,59,721,"Misdemeanor",325,264,61,62,50,12,387,279,276,11948
"Prowers",2015,341,157,48,205,"Felony",113,81,32,48,39,9,161,279,276,11948
"Prowers",2016,150,625,34,659,"Misdemeanor",273,223,50,34,29,5,307,156,151,11948
"Prowers",2016,342,179,52,231,"Felony",100,86,14,53,47,6,153,156,151,11948
"Pueblo",2014,151,2513,835,3348,"Misdemeanor",1496,1340,156,826,729,97,2322,14811,14494,162854
"Pueblo",2014,343,1364,481,1845,"Felony",588,453,135,481,420,61,1069,14811,14494,162854
"Pueblo",2015,152,2077,1332,3409,"Misdemeanor",1183,1021,162,1307,1145,162,2490,15182,14878,163063
"Pueblo",2015,344,1388,787,2175,"Felony",637,502,135,790,688,102,1427,15182,14878,163063
"Pueblo",2016,153,1906,1576,3482,"Misdemeanor",827,719,108,1506,1319,187,2333,15850,15529,163063
"Pueblo",2016,345,1607,657,2264,"Felony",644,541,103,651,586,65,1295,15850,15529,163063
"Rio Blanco",2014,154,193,12,205,"Misdemeanor",150,140,10,10,10,NA,160,182,177,6889
"Rio Blanco",2014,346,47,5,52,"Felony",35,26,9,9,6,3,44,182,177,6889
"Rio Blanco",2015,155,194,14,208,"Misdemeanor",138,111,27,15,15,NA,153,159,158,6744
"Rio Blanco",2015,347,33,10,43,"Felony",26,22,4,9,7,2,35,159,158,6744
"Rio Blanco",2016,156,129,24,153,"Misdemeanor",84,71,13,20,17,3,104,122,121,6744
"Rio Blanco",2016,348,55,13,68,"Felony",44,34,10,11,10,1,55,122,121,6744
"Rio Grande",2014,157,231,97,328,"Misdemeanor",97,67,30,104,79,25,201,310,307,11603
"Rio Grande",2014,349,100,61,161,"Felony",62,43,19,67,50,17,129,310,307,11603
"Rio Grande",2015,158,229,94,323,"Misdemeanor",104,82,22,87,70,17,191,427,423,11340
"Rio Grande",2015,350,73,63,136,"Felony",52,33,19,60,49,11,112,427,423,11340
"Rio Grande",2016,159,202,87,289,"Misdemeanor",103,77,26,84,69,15,187,556,547,11340
"Rio Grande",2016,351,115,50,165,"Felony",76,45,31,53,38,15,129,556,547,11340
"Routt",2014,160,385,166,551,"Misdemeanor",296,270,26,161,143,18,457,1007,977,23670
"Routt",2014,352,72,29,101,"Felony",53,43,10,30,26,4,83,1007,977,23670
"Routt",2015,161,365,172,537,"Misdemeanor",249,235,14,171,151,20,420,1049,1025,24065
"Routt",2015,353,95,65,160,"Felony",72,59,13,62,53,9,134,1049,1025,24065
"Routt",2016,162,309,176,485,"Misdemeanor",200,183,17,169,146,23,369,1001,967,24065
"Routt",2016,354,58,42,100,"Felony",39,31,8,40,34,6,79,1001,967,24065
"Saguache",2014,163,84,38,122,"Misdemeanor",35,25,10,38,34,4,73,201,196,6477
"Saguache",2014,355,18,23,41,"Felony",15,13,2,21,17,4,36,201,196,6477
"Saguache",2015,164,69,31,100,"Misdemeanor",29,26,3,30,26,4,59,210,205,6444
"Saguache",2015,356,19,19,38,"Felony",13,8,5,19,15,4,32,210,205,6444
"Saguache",2016,165,88,30,118,"Misdemeanor",35,27,8,26,23,3,61,239,237,6444
"Saguache",2016,357,48,14,62,"Felony",31,27,4,14,10,4,45,239,237,6444
"San Juan",2014,166,11,2,13,"Misdemeanor",3,2,1,1,1,NA,4,21,21,692
"San Juan",2014,358,3,1,4,"Felony",2,2,NA,1,NA,1,3,21,21,692
"San Juan",2015,167,19,1,20,"Misdemeanor",6,3,3,1,1,NA,7,14,14,726
"San Juan",2015,359,NA,NA,NA,"Felony",NA,NA,NA,NA,NA,NA,NA,14,14,726
"San Juan",2016,168,19,4,23,"Misdemeanor",8,5,3,2,2,NA,10,21,20,726
"San Juan",2016,360,8,5,13,"Felony",7,5,2,3,3,NA,10,21,20,726
"San Miguel",2014,169,134,33,167,"Misdemeanor",110,92,18,29,21,8,139,157,156,7806
"San Miguel",2014,361,28,7,35,"Felony",20,14,6,7,5,2,27,157,156,7806
"San Miguel",2015,170,143,30,173,"Misdemeanor",114,102,12,31,26,5,145,163,161,7995
"San Miguel",2015,362,48,6,54,"Felony",37,31,6,9,6,3,46,163,161,7995
"San Miguel",2016,171,209,25,234,"Misdemeanor",179,162,17,22,20,2,201,180,171,7995
"San Miguel",2016,363,46,12,58,"Felony",40,32,8,8,7,1,48,180,171,7995
"Sedgwick",2014,172,36,7,43,"Misdemeanor",20,19,1,6,6,NA,26,62,54,2370
"Sedgwick",2014,364,8,2,10,"Felony",7,4,3,2,1,1,9,62,54,2370
"Sedgwick",2015,173,56,15,71,"Misdemeanor",25,24,1,15,12,3,40,33,33,2352
"Sedgwick",2015,365,13,7,20,"Felony",10,6,4,7,7,NA,17,33,33,2352
"Sedgwick",2016,174,62,7,69,"Misdemeanor",31,29,2,7,7,NA,38,9,9,2352
"Sedgwick",2016,366,21,9,30,"Felony",13,12,1,8,8,NA,21,9,9,2352
"Summit",2014,175,862,63,925,"Misdemeanor",647,573,74,69,61,8,716,1434,1417,28965
"Summit",2014,367,209,13,222,"Felony",144,126,18,16,12,4,160,1434,1417,28965
"Summit",2015,176,938,110,1048,"Misdemeanor",709,616,93,107,89,18,816,1666,1636,29861
"Summit",2015,368,230,19,249,"Felony",164,128,36,20,14,6,184,1666,1636,29861
"Summit",2016,177,820,112,932,"Misdemeanor",570,511,59,108,84,24,678,1915,1886,29861
"Summit",2016,369,264,19,283,"Felony",189,160,29,20,13,7,209,1915,1886,29861
"Teller",2014,178,529,139,668,"Misdemeanor",406,367,39,127,114,13,533,1213,1167,23727
"Teller",2014,370,169,14,183,"Felony",110,93,17,9,8,1,119,1213,1167,23727
"Teller",2015,179,504,121,625,"Misdemeanor",341,302,39,111,100,11,452,1227,1205,23831
"Teller",2015,371,167,21,188,"Felony",101,96,5,18,16,2,119,1227,1205,23831
"Teller",2016,180,461,119,580,"Misdemeanor",278,244,34,114,110,4,392,1322,1272,23831
"Teller",2016,372,205,27,232,"Felony",134,113,21,27,24,3,161,1322,1272,23831
"Washington",2014,181,67,29,96,"Misdemeanor",43,42,1,31,29,2,74,99,89,4830
"Washington",2014,373,11,4,15,"Felony",5,3,2,4,3,1,9,99,89,4830
"Washington",2015,182,80,37,117,"Misdemeanor",54,47,7,36,33,3,90,142,127,4792
"Washington",2015,374,8,6,14,"Felony",6,5,1,6,6,NA,12,142,127,4792
"Washington",2016,183,97,25,122,"Misdemeanor",46,44,2,23,22,1,69,264,258,4792
"Washington",2016,375,21,12,33,"Felony",13,12,1,13,12,1,26,264,258,4792
"Weld",2014,184,3329,1343,4672,"Misdemeanor",2227,1839,388,1092,967,125,3319,13245,12754,289420
"Weld",2014,376,1648,468,2116,"Felony",824,659,165,483,391,92,1307,13245,12754,289420
"Weld",2015,185,3200,2156,5356,"Misdemeanor",2037,1631,406,1911,1658,253,3948,12749,12260,300619
"Weld",2015,377,1591,596,2187,"Felony",789,601,188,609,536,73,1398,12749,12260,300619
"Weld",2016,186,2677,2747,5424,"Misdemeanor",1627,1301,326,2256,1972,284,3883,14479,13920,300619
"Weld",2016,378,1887,647,2534,"Felony",877,679,198,655,533,122,1532,14479,13920,300619
"Yuma",2014,187,90,22,112,"Misdemeanor",65,60,5,21,20,1,86,86,86,10241
"Yuma",2014,379,32,3,35,"Felony",22,19,3,3,3,NA,25,86,86,10241
"Yuma",2015,188,121,30,151,"Misdemeanor",85,73,12,31,25,6,116,77,77,10287
"Yuma",2015,380,43,10,53,"Felony",34,19,15,9,6,3,43,77,77,10287
"Yuma",2016,189,107,39,146,"Misdemeanor",74,62,12,33,27,6,107,69,68,10287
"Yuma",2016,381,47,14,61,"Felony",32,26,6,14,12,2,46,69,68,10287
"Denver",2014,238,3817,1271,5088,"Felony",1936,1632,304,1313,1186,127,3249,46205,44831,665353
"Denver",2015,239,4036,1319,5355,"Felony",2069,1751,318,1446,1291,155,3515,49467,47931,682418
"Denver",2016,240,4037,2572,6609,"Felony",1902,1621,281,2619,2286,333,4521,51525,50021,682418
